#####################
#S#     #     #     #
# # ### ### # # # ###
# # #   #   # # #   #
# # ### # ### ##### #
# #   #   #   #     #
# ### ##### ### ### #
#   #   #   #   # # #
### ### # ### ### # #
#       #     #    E#
#####################