###################################################
#S    #       #     #     #     #         #       #
##### # ##### # ### # ### # ### # ####### # ##### #
#   #   #   #   #   #   # #   # # #     #     #   #
# # ##### # ##### ### # # # # # # # ### ####### ###
# #   #   #   #   #   # # # # # # #   # #     #   #
# # ### ##### # ####### # ### # # ### # # ### ### #
# #     #   #   #     # #   # # #   # # #   #   # #
# ####### # ####### # # ### # ##### # ##### ### # #
# #       # #     # # # # # #     # #     # # # # #
# ##### # # # ### # # # # # # ### # ##### # # # # #
#     # # # # # #   # # # # #   #         # #   # #
##### # # # # # ##### # # # ############# # ### # #
# #   # # # # #     # # # #   #       #   #   #   #
# # ### # # # # ##### # # ### # ##### ##### # ### #
#   #   # #   #     #   #   # # #   # #   # #   # #
# ##### # ##### ### ####### # # # ### # # ##### # #
#     # # #       #         # # #   # # #   #   # #
##### ### ####### ##### ### # # # # # # ### # #####
#   #   #     # #   #   #   #   # # #   #   #     #
# ##### # ### # ### # ############# ##### ####### #
#   #   # #   #     # #               #   #       #
# # # ##### ### ##### # ####### ### ### ### ##### #
# #   #   #   # # #   #   #   # #   #   #     #   #
# ##### # ### # # # ##### # ### # ### ### ### # ###
# #     #     # # #       #   # #   # #   # # # # #
# # ########### # ########### # ### # ### # # # # #
#   # #       #     #     #   #   # #   # # # #   #
##### # # ######### # ### # # ### ##### # # # ### #
#     # #         #   # #   # # #   #   #   # #   #
# ### # ##### ### ##### ##### # ### # ##### # # ###
#   # #   # # #       #   #     #   # #   # # # # #
# # # ### # # ######### # # ##### # # ### # # # # #
# # # #   # #     #     #   # #   # # #   # # # # #
# # ### ### ##### # ######### # # ### # ### # # # #
# #     #       #   #   #     # # #   #     # #   #
# ############# ##### # # ### # ### ### ##### ### #
#   #                 # #   # #   #   # #   # # # #
### ##### ############# ##### ### ### ### # # # # #
#         #                     #         #   #  E#
###################################################