###################################################
#S#       #     #     # #                   #   # #
# # ##### # ### # ### # # ######### ####### # # # #
#   #   #   #   # #     # #     #   #     #   #   #
##### ####### ### ####### # ##### ### ### ####### #
# #           #       #     #   # # # # #     #   #
# # ########### ##### # ##### # # # # # ### # # ###
#   #     #         #   #     #   # # #   # # #   #
# ### # ### ####### ##### ######### # # # # # ### #
# #   #       #   # #   #   #   #   # # # # # #   #
# # ########### # # # # ### # # # # # # # # # # ###
# # #   #     # # # # #   # # #   # # # # # # #   #
# ### # # ### # # ### ### # ### ### # # # # ##### #
#     #   #   # #     # # #   # # #     # #     # #
########### ### ####### # # # # # ######### ### # #
#         # #   # #     # # # #   #       # #   # #
# ####### # ### # # # ### # # ##### ##### ### # # #
#     #   # #   # # #     # #   #   # #   #   # # #
####### ### # ### # ########### # ### # ### ##### #
#     # #   #   #   #   #     #       # #   #   # #
# ### # # ### # # ### # # ### ####### # # ### # # #
#   #   # #   # #     #   #   #   #   # #     # # #
### # ### # ### ########### ### # ##### # ##### # #
#   # #   # # #   #       #     #   #   # # #   # #
# ##### ### # ### # ##### ######### # ### # # # # #
#     # #       # # #     #       # #   #   # # # #
# ### # ######### # # ### # ### ### # # ##### ### #
# # # #   #       # # # # # #   #   # #     #   # #
# # # ### # ####### # # # ### # # ### ##### # # # #
#   #   #   #       # #       # #   #   # # # #   #
# ### # ##### ####### ######### ### ### # # # #####
# #   #   # #   #     #   #   #   # #   # # #     #
# # ##### # ### # ##### # ### ### # # ### # ##### #
# # #   #     # #       #   #     # #     #     # #
# # # # ##### # ########### ####### ########### ###
# #   # #   # # #       # #       # #         #   #
# ##### # ### # ### ### # ####### # # ####### ### #
# #   # #     # #   # #   #   # #   #   #   #     #
# ### # ####### # ### ### # # # ####### # ####### #
#     #           #         #           #        E#
###################################################