#####################
#S  #     #         #
### ### # # ####### #
# # #   #   #     # #
# # # ####### # ### #
# # # #   #   # #   #
# # # # ### # # # ###
# # # #   # # # # # #
# # # # # # # ### # #
#     # #   #      E#
#####################