#####################
#S#   #           # #
# # # ##### ##### # #
#   # #   #   # # # #
##### # # ### # # # #
#   #   #     #   # #
# # ########### ### #
# #   #     #   #   #
# ### # ### # ### # #
#   #     #       #E#
#####################