#####################
#S  #         #     #
### # ### ### # ### #
#   #   # # #   #   #
# ####### # ##### ###
# #       # #   #   #
# ### ##### # # ### #
# #   #     # # #   #
# # ### ### # # # ###
#   #     #   #    E#
#####################