###################################################
#S  #                     #     #     #           #
### ##### ############# # # ##### # # ########### #
# #     # #     #   #   # #       # #   #         #
# ##### # ### # # # # ### # ####### ### # ####### #
# #     # #   # # # #   # #     #   # # # # #     #
# # ##### # # ### # ### # ##### # ### # # # # #####
#   #       # #   #     #     # #   # #   # #     #
# ########### # ############# ##### # ##### ##### #
# #         # # #   #     # # #     #     #     # #
# # ####### ### # # ### # # # # ##### ##### ### # #
# #     #   #   # #     # # #   #   #     # # #   #
# ##### # ### ### ####### # ##### ### ### # # #####
#     # #     #       #   #   #     # # #   #     #
##### # ########### # # ### # # ### # # ##### ### #
#     # #   #     # # #     # #   #   # #   # #   #
# ##### # # # ### ### ####### ### ##### # # # # ###
# #       #   # #   #   #     #   #     # # # #   #
# ### ####### # ### # # ####### ### ### # # # ### #
#   # #     #     # # #       # #     # # #   #   #
### ### ### ##### # # ####### # ##### # # ##### # #
# #   # #   #   # # # #   #   #     # # #   #   # #
# ### # # ### # ### # # # # ####### # # ### # ### #
#   #   #     #   # # # #   #     # # # #   #   # #
# # ############# # # # ##### # ### # ### ##### # #
# #     #       #   # #       #   # #     #     # #
### ##### ### ####### ########### # ####### ##### #
#   #   # # #     # # #         # #         #     #
# ### # # # ### # # # # ####### # ########### #####
# #   #   #   # #   #   #       #   #     # # #   #
# # ####### ### ######### ######### # # # # # ### #
#   #     # #   #             #   # # # #   #   # #
# ### ### # # ### ############# # # # # ####### # #
#   # # #   #     #   #         #   # #   #     # #
### # # ### ####### # # ########### # ### # ##### #
#   # #   #       # # #     #       #   #   #   # #
# ### # ######### # # ##### ### ####### ##### # # #
# #   # #     #   # #   # #   #   #     #     # # #
# # ### # ### # ### ### # ### ##### ######### # # #
#   #       #       #       #                 #  E#
###################################################