#####################
#S#         #       #
# ####### # # #######
#       # # #       #
####### # # ### ### #
#     #   #   # #   #
# ### ####### # # # #
#   #   #   # # # # #
### ### # # # ### # #
#     #   #       #E#
#####################