#####################
#S  #       #     # #
### # ##### # ### # #
# # #     #   # # # #
# # # ### ##### # # #
# # # #   # #   # # #
# # ### ### # # # # #
# #   #   #   #   # #
# ### ### # ####### #
#         #        E#
#####################