#####################
#S#             #   #
# # ##### ##### # # #
# #   #   #   # # # #
# ##### ### ### ### #
#       # #     #   #
######### # ##### ###
#   #     # #       #
# ### ### # ####### #
#       #          E#
#####################